###############
#S.........O.E#
#O#E..#.#..#..#
#O####.#...#..#
#.....#E..##..#
#.E#E......#.##
#O#####.#.....#
#..E#E#...##..#
#...#.....#E..#
#..E###...#...#
#...#E#..##.###
#...#.#.E#.OOO#
#####.......#O#
#######.#...#G#
###############